{
    "40005": 88000000028,
    "10010": 88000000025,
    "40010": 88000000026,
    "20003": 88000000027,
    "30008": 88000000029,
    "10007": 88000000030,
    "30009": 88000000035,
    "20004": 88000000036,
    "30010": 88000000037
}